NO ./assets/bookshelf.xpm
SO ./assets/bookshelf_01.xpm
WE ./assets/bookshelf_02.xpm
EA ./assets/bookshelf_03.xpm
F 220,100,0
C 225,30,0
1111111111111111
1001000000000011
1000000000000001
1000000001000001
1000000N00000001
1000000000000011
1000000000000001
1111111111111111