1111111111111
00010000000C1
1000011111001
100011E00000P
1111111111111
