1111111111111
1CC10000000C1
10110111111C1
1P0001EC000C1
1111111111111